22
11
0000111110000000000000
0000100010000000000000
0000130010000000000000
0011100311100000000000
0010030030100000000000
1110101110100000111111
1000101110111111100221
1030030000000000000221
1111101111010111100221
0000100000011100111111
0000111111110000000000
12
8
