21
20
000000000000001111000
000000000111111001000
000000000100000001000
000000000100111101110
011100111110111000010
110111100033301000010
103300033030001222211
100333100003001222221
103000103303301222221
111000100300001222221
001000103030301222221
001011111110111222221
001000100303001222221
001110103303031111111
000010100300000010000
000010103330333010000
000010100000001010000
000010111111111010000
000010000000000010000
000011111111111110000
2
5
