19
15
0000000000111100000
0000011110100100000
0001110011130100000
0011000000300100000
0110030331101100000
0100131100000100000
0101030330101110000
0100030100103011111
1111000010033010001
1111011030000000001
1200001110011111111
1220221011110000000
1222121000000000000
1222221000000000000
1111111000000000000
7
3
