13
16
0011111111100
0010201020100
0012020202100
0010202020100
0012020202100
0010202020100
0011100011100
0000100010000
1111110111111
1000000000001
1030303030301
1103030303011
0130303030310
0100030300010
0100111110010
0111100011110
6
13
