20
13
00001111111110000000
00111000110011111000
11100000010010001111
10033013010010022201
10100310311010121201
10011013001000022201
10310000301010121201
10000110011303022201
10301100010013121201
11033003000300322201
01300111111000011001
01000100001111111111
01111100000000000000
7
4
