17
13
11111111111111110
10000000000000010
10101111110000010
10100303030310010
10100030300011011
10101303031112221
10100030300112221
10111333030112221
10000010110112221
11111000110112221
00001111100000111
00000000100000100
00000000111111100
7
4
