17
17
00000001111000000
00001111001000000
00011001001000000
00010030301000000
01110130001111000
01003001130001000
01001000301031000
01001000000301111
01101111311000001
01031222221010001
01003222020310111
11001222221000100
10001110111111100
10330010010000000
10010000010000000
11111100010000000
00000111110000000
6
6
