14
15
11111000000000
10001100000000
10000100111100
10300111100100
10033030003100
11100130000110
01001100303011
01030011011021
01001311300121
01110003221121
00100001202221
00103301222221
00100111111111
00100100000000
00111100000000
3
5
