18
16
000000011111110000
011111110000010000
010000010303010000
013301000111111111
010111222222110001
010003222222110101
010111222222000001
110001111011101311
100130001003001010
100303330010311010
100030301113301010
111110000030001010
000011101110001010
000000100000100010
000000111111110010
000000000000011110
10
2
