22
13
0000001111111111110000
0000001002001100010000
0000001012000000010000
0111111011222101111000
1100112221111000001111
1030112220000301003001
1000002201101011011001
1111311131030010001011
0111001000011303301010
0100033010103010311010
0100000000000000000010
0111111111111111110010
0000000000000000011110
15
2
