28
20
0000000011111100000000000000
0000000010000111100000000000
0000001111103000100000000000
0000001000110000111100000000
0000001031100110000100000000
0000001000100111110100000000
0000001013303000010100000000
0000001003030111010100000000
0000001010003001010100000000
0000001010013100010100000000
0000011011110001010100000000
0000010030011111010101111000
0000110000300000300111001111
1111100111030310301000222221
1000001100000010011001222221
1033330000111111311000121121
1100001100000000000000122221
0110011111111111111100022221
0010010000000000000111110011
0011110000000000000000011110
12
1
