14
10
11111111111100
12200100000111
12200103003001
12200131111001
12200000011001
12200101003011
11111101130301
00103003030301
00100001000001
00111111111111
7
4
