20
20
00000001111111111110
00000001222222222210
00000111212121212210
00000100022222222210
00000100303030020210
00001111111011111110
01111000100001100100
11000030100001030110
10013101110111300011
10300303000103030301
10010301100000001301
10003111131111311001
11110011000100001001
00013011000101033001
00010001030100300001
00011101033010030111
00000101000010301100
00000101111111101000
00000100000000001000
00000111111111111000
6
4
