16
14
0001111111111000
0001220010001000
0001220000001000
0001220010011110
0011111110010011
0010000000000001
0010010011001001
1111011001111011
1003001111101001
1010300300103001
1003003000100011
1111011011111110
0001000010000000
0001111110000000
2
10
