22
20
0000000000001111000000
0111111111111001111100
0100001001003001000110
0103030300301030300010
0113030001001030003010
1110001111111111110110
1003031001222222103100
1010001001222222110100
1001101101022222100100
1010000003222222030100
1010301101222222100100
1003031001222222103100
1030001001131111100100
1030301111030300303100
1101000003030303000111
0100111111030000300001
0100000000010111111101
0111111101300000000001
0000000100011111111111
0000000111110000000000
11
4
