25
14
0000000111111100000000000
0000000100100111100000000
0000000103130100110000000
1111111100100100011111111
1222200103130100310010001
1222210100000130010000001
1221200003100103000013001
1222001100130130010010001
1222201103100000311111111
1111111100133130010000000
0000000103100100310000000
0000000100100100010000000
0000000111100111110000000
0000000000111100000000000
5
7
