21
19
000111111111100000000
000122222222111100000
000121212222100100000
000122222222330100000
000100000211100111100
011111111100301000100
010000030003030030100
010010000100303100100
011011111000100100100
010300000100011110100
110031000101100100100
100001131110000100110
103000030100100100010
111110000101101011011
000013101003003030001
000010100313330010001
000011100300000011111
000000110010010010000
000000011111111110000
5
15
