23
17
00000000000000011110000
00000000001111110011111
00001111111000000010001
00001000000303011010101
00001001111030010000021
00001000000301010112121
00001131111303030112121
00001000001000011112111
00001030001111110012121
11111133311000000012121
10000001000013131112021
10111101333330000102221
10100003000001000102221
10100011011000001112221
10111111311111100111111
10000000010000100100000
11111111110000111100000
17
9
