15
15
111111111000000
100000001000000
100000001111000
110111101001000
110101100001000
103330300331000
100101103001000
100101100301111
111100333031001
010001100022221
010100010122021
010001010112221
011111030012221
000001100011111
000000111110000
4
4
