23
13
01111111111111111100000
01222000100001000111000
11222220031101010301000
12222221003001003001000
12222221001001010101100
11111111103003010100111
00100000131130110110001
01100030000103003000101
01001101110100111113101
01030330000030003000001
01030000311301111111101
01111111000011000000111
00000001111110000000000
10
11
