15
17
000001111111000
000001001001000
000001030001000
000011101101000
011110300101100
010000000100110
010303111103010
010330100100310
013003000130010
110033100033011
103300100100301
100000111103001
100131122110001
111021222211111
001022222221100
001222200022100
001111111111100
6
1
