24
11
000000000000000011111000
000000011111101110001111
000111110000111030300301
111100110130300003010001
122220003303030030001311
122010110100011131101001
122220000101110000100001
122220000101100300111301
122111111003001001111011
111100001000111000000010
000000001111111111111110
19
9
