17
10
00000000111111110
00000000100000010
00000000103130110
00000000103003100
00000000113030100
11111111103010111
12222001103003001
11222000030030001
12222001111111111
11111111000000000
14
1
