14
20
01111100000000
01000111111100
01030111000100
01030000330100
01101111000100
11101001011100
10001001011000
10330000301000
10001010301111
11111010001001
01000311110001
01003000003001
01100011111011
01111111111001
11222210300301
12222210331001
12202210300301
12222230001001
11001111111111
01111000000000
8
6
