15
12
011111110000000
010010011111000
110010012221110
100310012220010
103013302220010
100310012220210
100010311111111
113000000030301
110010033010001
011111100113301
000000100000011
000000111111110
13
9
