18
16
001111000000000000
001001111111110000
011001100100010000
010031030300011110
013003001030310011
110031101303000001
100100101000333001
103000030031101111
103030131001001000
110011100111301000
010012222000001000
011112222221111000
000122221111000000
000122211000000000
000122210000000000
000111110000000000
8
2
