13
15
0000001111000
0011111001000
0110000031000
1103001101110
1030301030010
1111011000310
0122221303010
0122221000310
0122220033011
0122201030001
0111111303001
0000001000111
0000001301110
0000001001000
0000001111000
1
4
