12
15
111111111111
110000011001
110003000301
111101103301
100030100001
103330101111
100010103011
100100100301
103103100001
100022101111
111122030101
122222103101
112222100301
111221100001
111111111111
10
10
