20
16
11111111111100111111
10001000010111122221
10003310000000222221
10001011100011022221
11011011100100022221
01030300000101101111
01003031100100000001
11110100111101101101
10010130001101100001
10300300101101111111
10103030000101000000
10030110110101000000
10330000033001000000
11011011103001000000
01000010100001000000
01111110111111000000
10
1
