18
19
000001111000000000
000111001100000000
111100300100000000
100030300111100000
103000103000101111
100100100030101221
113130111131111221
010001111101102221
013101101101100221
010100003000002221
010001111011100221
011101101001102221
001130111130111221
001000110000101221
011033110030101111
010000033330100000
010301110000100000
010001011111100000
011111000000000000
7
8
