21
15
111111111110000000000
122222200011111111100
122222200010011000100
122111030000300000100
122203030100111000100
122213111110000100100
111000010001300103111
001003303030031100301
001003000131001100001
001110110100301111111
000100303011011000000
000100003003001000000
000110001010001000000
000011111011111000000
000000001110000000000
9
13
