14
15
01111111110000
01222200011000
01212100301100
11222210100110
10222210010011
10000013011301
11011100300001
01300303031001
01010030301101
01001110011001
01000011011011
01003010030010
01113030001110
00010011111000
00011110000000
10
3
