23
18
00000000000000111000000
00000000000001121110000
00000000000001222210000
01111111111111222210000
11000110000011222211111
10033110030011222200001
10000003303100222210001
10030110330101222210011
10030110300101101110010
11011111011100000000010
11000300301111101110010
10311100101111101011110
10003000100000001000000
10030130303111001000000
10333103000101111000000
10000100330100000000000
11111100011100000000000
00000111110000000000000
11
5
