22
13
0000000000000011111111
0000000000000010022221
0001111111111110022221
0001000010030300022221
0001033313003010022221
0001003000003010022221
0001033013030311111111
1111003010000010000000
1000101111111110000000
1000030011000000000000
1033133001000000000000
1000100011000000000000
1111111110000000000000
8
10
