11
11
00000011110
11111110010
10000030010
10003110310
11312221010
01032220010
01012021011
01000101301
01300300001
01001111111
01111000000
8
1
