20
15
00000000000111110000
00000000001100011000
00000000011000001000
00000000110033001000
00000001103300301000
00000001030000301000
11110001000330111110
10011111111011000010
12200000000000333010
12101111111011000110
12101111111201303111
12222222222201000301
11111111111111003001
00000000000001100111
00000000000000111100
17
8
