13
18
0111111110000
0101100011110
0103000300010
0100303033310
0103310100010
1130000300010
1003003333311
1031111010001
1003222210001
1011222213301
1011222200011
1000222210010
1101222213310
0101222210010
0100000000010
0111101131110
0000100001000
0000111111000
2
1
