17
16
00001111111111110
00001000000000011
00001001013303001
00001301310011001
00011011010301011
00010003013001010
00010001030001010
00011030300011010
00010010011003010
00010000110331010
11111133000100010
12222100111111110
12122201100000000
12222000100000000
12222000100000000
11111111100000000
15
3
