25
19
0000001111110000000000000
0001111100010000000000000
0001000101011111000000000
0001030100300001111110000
0011300111011000000010000
1110033030301001100011111
1000000030001111110110001
1001111111101000010100101
1101110000001111013101001
0101110111101122010003011
0100300300131122013110011
0100101010000022110110301
0111100010110122100003001
0000111110000122101010011
0000000011111122100010110
0000000000000122111110010
0000000000000122000000010
0000000000000110011100110
0000000000000011111111100
13
7
