19
11
0000000011111110000
0000111110010011110
0000100010003000010
0111101330110110010
1100000010100110111
1001110313003003001
1222000010110010001
1222100000010111011
1222100111003003001
1111111101100010001
0000000000111111111
9
7
