22
17
0000111111111001111000
0000100011001111001000
0000100030001003001000
0000100101101000001111
0000110300030331010001
0000111100100103030001
1111100111100001112221
1000130100101111222221
1000000100101011222221
1111110100130001112221
0001000110103100012221
0011000000030031011111
0110333110010300010000
0100010010111001110000
0100030013001111000000
0111110010001000000000
0000011111111000000000
11
14
