19
15
0111110000000000000
0100010000000000000
0101011111100000000
0100000030111111000
0103011301110001000
0101111030000301000
0101111101001301111
1100111101130000001
1003100300101101101
1000000000101222101
1111110011100222001
0000011110101222101
0000000000101110101
0000000000100000001
0000000000111111111
9
3
