16
15
0000000111100000
0000000100110000
0000000100011000
0000000103301100
0000011130030110
0011110000300010
1110010111110010
1000010122223010
1010003022221010
1003010120221010
1110011110111010
0011110030011311
0000011103000001
0000000100110001
0000000111111111
7
11
