19
16
0000001111111111110
0000011220000100010
0000112200300003010
0001122021010130110
0001220210101030010
1111222100100001010
1001101000000000010
1003030111001010110
1030003000101000100
1113300010101010100
0010003000101011111
0010310111110000001
0013000100010001001
0010011100011000001
0010010000001000011
0011110000001111110
2
7
