17
13
00000000111110000
00000000100011111
00000000101311001
00000000100000301
11111111101110001
12222001103003111
12222000030330110
12222001130030010
11111111100300110
00000000103030010
00000000111011010
00000000001000010
00000000001111110
14
7
