21
16
000001111111111111000
000001000011100001000
000001000003030011110
000111101000303000010
001103001311110303010
111000101000111003010
103003001003001011110
101131111013100300111
101100111010101003001
100000300030001030101
111110010011001031001
001222011111300100101
001222222210330130101
001222222210000000001
001222222211111110011
001111111110000011110
5
9
