16
14
1111101111000000
1222101001111000
1222111003001000
1222211030031110
1122221100030010
1112220110303010
1011000010030010
1001101011101111
1030101300300001
1003000300003001
1000103033030111
1001111110011100
1011000011110000
1110000000000000
5
9
