21
14
011110000000000000000
110011111000000000000
100000001011111000000
103111001110001000000
122100310100101000000
122100000033101110000
120101001303000011111
122100110000011310001
120300301011003000001
122110030001000111111
120113110001111100000
122003011111000000000
100100010000000000000
111111110000000000000
5
12
