13
19
0001111111111
0001001110001
0001030003001
0001001111311
0001101001001
0011001200001
0010011221001
0010001201011
0010131221301
0010301221001
0010101001001
0010301221311
0010000201001
0111001001001
1100001111001
1001111111311
1030000003001
1001100010001
1111111111111
4
7
