23
20
01111111111111111111110
01000110010001000100010
01030000030003000300011
11111010010001110113111
10001011311111100010001
10300010222222100010301
11010010222222111110001
11011111111122100010111
10000000000122103000100
10110111011122110100111
10100010001122110111001
10000000000322100000001
10100010001100100011001
11111011111111111111011
10000000000100010000301
10300103030300010100001
10131103100110110000101
10030330111103003010101
10000000000100010000001
11111111111111111111111
4
11
