22
15
0111111111111111111111
1100000000000000000001
1000030100000011010001
1001111110111001311011
1131000113122220001010
1001000030122221101010
1030101010122221100010
1030133000122221131010
1010303113122221100010
1000333000122221000010
1003100010111111031110
1100101113300300030100
1100000103003011000100
0111110001000111111100
0000011111111100000000
5
8
