14
16
11111111110000
10000000011110
10111111010011
10103030300301
10000000130001
11130033100111
00100110103110
00113100030010
00010030301110
00010100030010
00010110001010
00110011111010
00100000000010
00122222221110
00122222221000
00111111111000
11
7
