18
11
000000000111100000
011111111100110000
110030000003011111
100011011000112221
101330303313112221
101000000010002221
100310111330002221
103003300301122221
111300000001111111
001001111111000000
001111000000000000
7
5
