27
20
000000000000001111110000000
000000000011111000010000000
000000000010011010011111000
000000000010000212210001000
011111011110312122200001000
010001110011010222211011000
010300000011012212211010000
111111010001010211111010000
100010313101012211111010000
103003000001010200001010000
110110030111010011001010000
010030030111011111011010000
011131113111001111011010000
111101000000000111001010000
100301003111100111331011111
100000030101001111001310001
111101003101000000000000001
000100300101100110011111111
000110011100111111110000000
000011110000000000000000000
21
14
