29
20
00000000011110000000000000000
00000000010010000000000000000
00000000010011111111000000000
00011111110010000001000000000
00010001010101010001100000000
00010300000300110030100000000
00111031010010100000111111111
00100300100310103301000101001
01101000100000111000030101001
01001300010111001001033101001
01000031103001000110300101011
11113030100001100100030000221
10010000111010303011100111201
10000011003300003000001122221
10011001100030013100112222021
11010030010103110011222202111
11011003001030100122220211100
10000301111000102222021110000
10001001001001002202111000000
11111111001111111111100000000
13
13
