12
11
111111001110
122001011011
122001110001
122000003301
122001010301
122111010301
111103013001
000100310301
000103003001
000100110001
000111111111
9
1
