26
16
00000000111110000000000000
00000000100011110000000000
00000000103000011110011110
00000000100010310011110010
11111111111010003000100010
12200000103001111010010010
12230010003001003010302110
12010103030110011000012100
12213000100011000033012100
12210303003030110001102100
12033010110003013103012100
12210000001100010000012100
12211111110011101111112110
10330000000000000000000211
10011111111111111111100221
11110000000000000000111111
6
8
