13
12
0000000111110
0111111100011
1101001103301
1000030000001
1003001110001
1110111113111
1030011102210
1030303022210
1000011122210
1033010122210
1001110111110
1111000000000
5
2
