16
17
0011110000000000
0010011111111111
0010000300030301
0010310301003001
0010030300100001
1110310100111101
1013030300110001
1000030131000101
1100300003030301
0111100111111111
0011100111000000
0010000001000000
0010000001000000
0012222221000000
0012222221000000
0012222221000000
0011111111000000
1
6
