17
18
00000000001111111
00000000001002221
00000011111002221
00000010000002221
00000010011002221
00000011011002221
00000111011111111
00000103330110000
01111100303011111
11000130300010001
10030030000300301
11111103303011111
00000103000010000
00000111101110000
00000000100100000
00000000100100000
00000000100100000
00000000111100000
1
10
